########################################
# @ ######                             #
#    *   ###############################
####   * #   #                   #     #
#  #  #### # # ############# ### # # # #
# ##       # * #   #       # #*# # # # #
#    *########## ### ### # # # # # # # #
# *              #   #*  # # # #   # # #
#################### #   # ### ##### # #
#                  # ### #  *  # *   # #
#                  #   # ###### * #### #
#                  ######  *      #  * #
#                     ####### * ########
#                  #         **        #
####################################---#