


	#   #
	#   ######
	#        ###############################
	####                                   #
	#  #                                   #
	#  #                                   #
	#                                      #
	#                                      # 
	####################                   #
                   	   #  ##               #
		   	   #   #      #   #    #
                           #  ###    * *  #    #
	                   #  ####### * ########
                           #           * * * * #
                   	   ################# * #